#Mod additions
ABE = "countries/Abenberg.txt"
AGR = "countries/Agrigento.txt"
AGC = "countries/Algeciras.txt"
ALM = "countries/Almeria.txt"
ALP = "countries/Alpuente.txt"
ADE = "countries/Andechs.txt"
ARC = "countries/Arcos.txt"
BDJ = "countries/Badajoz.txt"
BLS = "countries/Bilstein.txt"
COA = "countries/Carmona.txt"
CMG = "countries/Chiemgau.txt"
DGS = "countries/Dagsburg.txt"
DNA = "countries/Denia.txt"
EST = "countries/Este.txt"
FCL = "countries/Forcalquier.txt"
INN = "countries/Inntal.txt"
KLB = "countries/Katlenburg.txt"
LFF = "countries/Lauffen.txt"
LTC = "countries/Lutici.txt"
MGG = "countries/Malaga.txt"
MRN = "countries/Moron.txt"
NBG = "countries/Neuburg.txt"
PLM = "countries/Palermo.txt"
PRY = "countries/Peremyshl.txt"
RND = "countries/Ronda.txt"
RTT = "countries/Rottenburg.txt"
SIV = "countries/Silves.txt"
SPR = "countries/Sprevani.txt"
SDE = "countries/Stade.txt"
SDL = "countries/Stendal.txt"
SYC = "countries/Syracusa.txt"
TTO = "countries/Tortosa.txt"
TPN = "countries/Trapani.txt"
ZGZ = "countries/Zaragoza.txt"
ZNY = "countries/Zvenyhorod.txt"
PHE = "countries/Peceneks.txt"
KKN = "countries/Koknese.txt"
SEO = "countries/Selonia.txt"
JRK = "countries/Jersika.txt"
CKL = "countries/Ceklis.txt"
KVA = "countries/Karsovia.txt"
LZZ = "countries/Liezizi.txt"
UKN = "countries/Ukrani.txt"
RII = "countries/Riaciani.txt"
ZII = "countries/Zemzizi.txt"
LII = "countries/Linoni.txt"
MZZ = "countries/Murizzi.txt"
AYL = "countries/Argyll.txt"
ILE = "countries/Islay.txt"
ASE = "countries/ASEngland.txt"
SCY = "countries/Strathclyde.txt"
FFE = "countries/Fife.txt"
VXE = "countries/Vexin.txt"
REE = "countries/Reims.txt"
PLL = "countries/Pallars.txt"
URG = "countries/Urgell.txt"
CDY = "countries/Cerdanya.txt"
BSU = "countries/Besalu.txt"
EMP = "countries/Empuries.txt"
SKN = "countries/Skane.txt"
KLY = "countries/Kiralyfold.txt"
SZK = "countries/Szekelyfold.txt"
LMT = "countries/Lamata.txt"
BJN = "countries/Bojano.txt"
GGN = "countries/Gargano.txt"
FGA = "countries/Foggia.txt"
LRN = "countries/Larino.txt"
CHT = "countries/Chieti.txt"
AVS = "countries/Aversa.txt"
CRK = "countries/Cork.txt"
DBL = "countries/Dublin.txt"
FAS = "countries/Fagaras.txt"
BAE = "countries/Barsei.txt"
LVI = "countries/Lovistea.txt"
BLH = "countries/Blahnita.txt"
COV = "countries/Craiova.txt"
BNZ = "countries/Burnaz.txt"
VSC = "countries/Vlasca.txt"
VLS = "countries/Vlasia.txt"
BZG = "countries/Baragan.txt"
VLH = "countries/Vlahia.txt"
ROI = "countries/Romani.txt"
IAS = "countries/Iasi.txt"
ONT = "countries/Onut.txt"
CDR = "countries/Codru.txt"
MSK	= "countries/Minsk.txt"
TUV	= "countries/Turov.txt"
PNK	= "countries/Pinsk.txt"
SKS	= "countries/Slutsk.txt"
VHN	= "countries/Volhynia.txt"
BTY = "countries/Berestye.txt"
LSK = "countries/Lutsk.txt"
DGO = "countries/Dorogobuzh.txt"
LAD = "countries/Ladik.txt"
TVS = "countries/Tavas.txt"
VNL = "countries/Veinala.txt"
KRN = "countries/Kran.txt"
LVC = "countries/Lovech.txt"
PPO = "countries/Philippopolis.txt"
SNI = "countries/Sasni.txt"
KLU = "countries/Kulmas.txt"
PLK = "countries/Poleksia.txt"
DNV = "countries/Dainava.txt"
NLS = "countries/Nalsia.txt"
DLT = "countries/Deltuva.txt"
UPY = "countries/Upyte.txt"
NRS = "countries/Neris.txt"
SUA = "countries/Siaulia.txt"
ZGR = "countries/Zagare.txt"
TVT = "countries/Tervete.txt"
DBE = "countries/Doube.txt"
PMR = "countries/Piemare.txt"
DUZ = "countries/Duvzare.txt"
PLS = "countries/Pilsotas.txt"
DZK = "countries/Dzukia.txt"
AUK = "countries/Aukstaitia.txt"
LUV = "countries/Lietuva.txt"