#Mod additions
APL = "countries/Apulia.txt"
CUE = "countries/Cuneo.txt"
SLR = "countries/Salerno.txt"
TNC = "countries/Trinacria.txt"
AOE = "countries/Arborea.txt"
CGL = "countries/Cagliari.txt"
GLL = "countries/Gallura.txt"
LGU = "countries/Logudoro.txt"
OVI = "countries/Orvieto.txt"
JES = "countries/Jesi.txt"
OSI = "countries/Osimo.txt"
CAL = "countries/Cagli.txt"
ASZ = "countries/Assisi.txt"
GBB = "countries/Gubbio.txt"
SNA = "countries/Sarsina.txt"
CST = "countries/Castello.txt"
FLG = "countries/Foligno.txt"
FBR = "countries/Fabriano.txt"
PRT = "countries/Prato.txt"
PST = "countries/Pistoia.txt"
VLT = "countries/Volterra.txt"
COE = "countries/Colle.txt"
CRT = "countries/Cortona.txt"
GSS = "countries/Grosseto.txt"
TDZ = "countries/Tredozio.txt"
MSM = "countries/MassaMarittima.txt"
MTP = "countries/Montepulciano.txt"
SMT = "countries/SanMiniato.txt"
PTM = "countries/Pontremoli.txt"
CMO = "countries/Como.txt"
BCI = "countries/Brescia.txt"
BGM = "countries/Bergamo.txt"
CMA = "countries/Cremona.txt"
CRM = "countries/Crema.txt"
LDI = "countries/Lodi.txt"
PCZ = "countries/Piacenza.txt"
PVA = "countries/Pavia.txt"
TTN = "countries/Tortona.txt"
AAA = "countries/Alessandria.txt"
IVR = "countries/Ivrea.txt"
NVR = "countries/Novara.txt"
BLU = "countries/Belluno.txt"
VCZ = "countries/Vicenza.txt"
TRV = "countries/Treviso.txt"
FZU = "countries/Fiorenzuola.txt"
BOB = "countries/Bobbio.txt"
PSH = "countries/Poschiavo.txt"
FGN = "countries/Frignano.txt"
CVL = "countries/Clavesana.txt"
FSO = "countries/Fossano.txt"
SVL = "countries/Savigliano.txt"
CSC = "countries/Cherasco.txt"
AQE = "countries/AquiTerme.txt"
WFR = "countries/WestFrisia.txt"
HST = "countries/Humsterland.txt"
MOO = "countries/Moormerland.txt"
NRD = "countries/Norderland.txt"
FDG = "countries/Federgo.txt"
ESG = "countries/Emsigerland.txt"
RHD = "countries/Rheiderland.txt"
OHI = "countries/Orihuela.txt"
LRC = "countries/Lorca.txt"
MCA = "countries/Murcia.txt"
NIE = "countries/Niebla.txt"
SEV = "countries/Sevilla.txt"
MNR = "countries/Menorca.txt"
VLK = "countries/Valencia.txt"
JAE = "countries/Jaen.txt"
TLD = "countries/Toledo.txt"
CRD = "countries/Cordoba.txt"
ARR = "countries/Albarracin.txt"
MLL = "countries/Mallorca.txt"
NDR = "countries/Nadrauwa.txt"
SKL = "countries/Skallawa.txt"
NTG = "countries/Notangi.txt"
GLD = "countries/Galinda.txt"
BTA = "countries/Barta.txt"
PDD = "countries/Paguddi.txt"
WMI = "countries/Warmi.txt"
PMD = "countries/Pameddi.txt"
LOB = "countries/Lobavia.txt"
ZMG = "countries/Samogitia.txt"
YTV = "countries/Yotvingia.txt"
KUS = "countries/Kursi.txt"
ZGL = "countries/Zemgali.txt"
SND = "countries/Sandomierz.txt"
SIR = "countries/Sieradz.txt"
KUJ = "countries/Kujavia.txt"
WKP = "countries/Wielkopolska.txt"
KSZ = "countries/Kalisz.txt"
BSS = "countries/Bresse.txt"
DRX = "countries/Dreux.txt"
CTS = "countries/Chartes.txt"
CDE = "countries/Ceredigion.txt"
PWF = "countries/PowysFadog.txt"
PYS = "countries/Powys.txt"
GWY = "countries/Gwynedd.txt"
CTM = "countries/CantrefMawr.txt"
AAB = "countries/Alba.txt"
BRK = "countries/Brecon.txt"
PMK = "countries/Pembroke.txt"
GLM = "countries/Glamorgan.txt"
BUI = "countries/Builth.txt"
ELF = "countries/Elfael.txt"
HLS = "countries/Hals.txt"
GOW = "countries/Gower.txt"
KDW = "countries/Kidwelly.txt"
MNM = "countries/Monmouth.txt"
SVE = "countries/Severin.txt"
OLT = "countries/Oltenia.txt"
MNT = "countries/Muntenia.txt"
BDC = "countries/Brodnici.txt"
CEA = "countries/Ceangai.txt"
CMN = "countries/Cumani.txt"
SIA = "countries/Sofia.txt"
KRV = "countries/Karvuna.txt"
SAA = "countries/Salona.txt"
BDN = "countries/Bodonitsa.txt"
NGR = "countries/Negroponte.txt"
TNS = "countries/Tinos.txt"
NKA = "countries/Nikaia.txt"
ATA = "countries/Arta.txt"
GJR = "countries/Gjirokaster.txt"
VLO = "countries/Vlore.txt"
KKU = "countries/Kuku.txt"
BNB = "countries/BeniAbbas.txt"
VZH = "countries/Velbazhd.txt"
PRP = "countries/Prilep.txt"
KSV = "countries/Kosovo.txt"
PRJ = "countries/Primorje.txt"
SYM = "countries/Syrmia.txt"
DNN = "countries/Dunantul.txt"
RSZ = "countries/Reszek.txt"
TSZ = "countries/Tiszantul.txt"
UNG = "countries/Ung.txt"
BRS = "countries/Borsod.txt"
NGD = "countries/Nograd.txt"
VLI = "countries/Villingen.txt"
SBL = "countries/SaintBlaise.txt"
BDF = "countries/Bonndorf.txt"
HRB = "countries/Hornberg.txt"
TBG = "countries/Triberg.txt"
WFC = "countries/Wolfach.txt"
KLT = "countries/Klettgau.txt"
SUZ = "countries/Sulz.txt"
TUB = "countries/Tubingen.txt"
CLW = "countries/Calw.txt"
VAI = "countries/Vaihingen.txt"
VRG = "countries/Veringen.txt"
HEI = "countries/Heiligenberg.txt"
SHK = "countries/Schelklingen.txt"
DLL = "countries/Dillingen.txt"
LFB = "countries/Laufenburg.txt"
BLM = "countries/Belmont.txt"
VRS = "countries/Vares.txt"
UPN = "countries/Unspunnen.txt"
SGS = "countries/Sargans.txt"
AAR = "countries/Aargau.txt"
WSL = "countries/Wesel.txt"
BPP = "countries/Boppard.txt"
REI = "countries/Rheingraviate.txt"
WGR = "countries/Wildgraviate.txt"
DRN = "countries/Durne.txt"
MUZ = "countries/Munzenberg.txt"
BUH = "countries/Butenheim.txt"
HXB = "countries/Horburg.txt"
CMC = "countries/Commercy.txt"
SAB = "countries/Saarbrucken.txt"
BRY = "countries/Briey.txt"
APR = "countries/Apremont.txt"
CNY = "countries/Chiny.txt"
VNE = "countries/Vianden.txt"
SWR = "countries/Saarwerden.txt"
PML = "countries/Pomeralia.txt"
RST = "countries/Rostock.txt"
STL = "countries/Stralsund.txt"
PCH = "countries/Parchim.txt"
DDD = "countries/Dannenberg.txt"
LUU = "countries/Luchow.txt"
WTH = "countries/WallachianThessaly.txt"
KSW = "countries/Kaiserswerth.txt"
DUI = "countries/Duisburg.txt"
CJK = "countries/Cuijk.txt"
KUI = "countries/Kuilenburg.txt"
RVS = "countries/Ravenstein.txt"
BDK = "countries/Bederkesa.txt"
WTG = "countries/Wittgenstein.txt"
DSS = "countries/Dassel.txt"
SLB = "countries/Schwalenberg.txt"
WOP = "countries/Wople.txt"
DPE = "countries/Depenau.txt"
ARN = "countries/Arnsberg.txt"
WLD = "countries/Woldenberg.txt"
HBE = "countries/Hausberge.txt"
HCK = "countries/Huckeswagen.txt"
PSS = "countries/Plesse.txt"
DRD = "countries/Dresden.txt"
LNG = "countries/Leisnig.txt"
DWN = "countries/Dewin.txt"
CDZ = "countries/Colditz.txt"
BHN = "countries/Brehna.txt"
ARS = "countries/Arnstein.txt"
GLS = "countries/Gleichenstein.txt"
KVR = "countries/Kevernburg.txt"
QRT = "countries/Querfurt.txt"
SZA = "countries/Salza.txt"
KTB = "countries/Klettenberg.txt"
LBD = "countries/Lobdeburg.txt"
WTB = "countries/Wiltberg.txt"
HIG = "countries/Hirschberg.txt"
ABN = "countries/Abensberg.txt"
LGM = "countries/Lechsgemund.txt"
MOB = "countries/Moosburg.txt"
LOE = "countries/Leonburg.txt"
HBC = "countries/Harbach.txt"
GDG = "countries/Goldegg.txt"
ESC = "countries/Eschenlohe.txt"
MER = "countries/Merania.txt"
ETL = "countries/Ernestinischelande.txt"
AUC = "countries/Auricherland.txt"
LEM = "countries/LatinEmpire.txt"
GNV = "countries/Geneva.txt"
ABG = "countries/Albenga.txt"
DSD = "countries/Darmstadt.txt"
PHI = "countries/Philadelphia.txt"
MBK = "countries/Mosbach.txt"
AAI = "countries/AdriaticIslands.txt"
EGE = "countries/Eger.txt"
VLY = "countries/Velay.txt"
BOO = "countries/Bolohoveni.txt"
ONU = "countries/Onutului.txt"
SSN = "countries/Strasinetului.txt"
BDI = "countries/Berladnici.txt"
ARB = "countries/Arenberg.txt"
RTG = "countries/Rietberg.txt"
RUM = "countries/Rum.txt"
ABE = "countries/Abenberg.txt"
AGR = "countries/Agrigento.txt"
AGC = "countries/Algeciras.txt"
ALM = "countries/Almeria.txt"
ALP = "countries/Alpuente.txt"
ADE = "countries/Andechs.txt"
ARC = "countries/Arcos.txt"
BDJ = "countries/Badajoz.txt"
BLS = "countries/Bilstein.txt"
COA = "countries/Carmona.txt"
CMG = "countries/Chiemgau.txt"
DGS = "countries/Dagsburg.txt"
DNA = "countries/Denia.txt"
EST = "countries/Este.txt"
FCL = "countries/Forcalquier.txt"
INN = "countries/Inntal.txt"
KLB = "countries/Katlenburg.txt"
LFF = "countries/Lauffen.txt"
LTC = "countries/Lutici.txt"
MGG = "countries/Malaga.txt"
MRN = "countries/Moron.txt"
NBG = "countries/Neuburg.txt"
PLM = "countries/Palermo.txt"
PRY = "countries/Peremyshl.txt"
RND = "countries/Ronda.txt"
RTT = "countries/Rottenburg.txt"
SIV = "countries/Silves.txt"
SPR = "countries/Sprevani.txt"
SDE = "countries/Stade.txt"
SDL = "countries/Stendal.txt"
SYC = "countries/Syracusa.txt"
TTO = "countries/Tortosa.txt"
TPN = "countries/Trapani.txt"
ZGZ = "countries/Zaragoza.txt"
ZNY = "countries/Zvenyhorod.txt"
PHE = "countries/Peceneks.txt"
KKN = "countries/Koknese.txt"
SEO = "countries/Selonia.txt"
JRK = "countries/Jersika.txt"
CKL = "countries/Ceklis.txt"
KVA = "countries/Karsovia.txt"
LZZ = "countries/Liezizi.txt"
UKN = "countries/Ukrani.txt"
RII = "countries/Riaciani.txt"
ZII = "countries/Zemzizi.txt"
LII = "countries/Linoni.txt"
MZZ = "countries/Murizzi.txt"
AYL = "countries/Argyll.txt"
ILE = "countries/Islay.txt"
ASE = "countries/ASEngland.txt"
SCY = "countries/Strathclyde.txt"
FFE = "countries/Fife.txt"
VXE = "countries/Vexin.txt"
REE = "countries/Reims.txt"
URG = "countries/Urgell.txt"
CDY = "countries/Cerdanya.txt"
BSU = "countries/Besalu.txt"
EMP = "countries/Empuries.txt"
SKN = "countries/Skane.txt"
KLY = "countries/Kiralyfold.txt"
SZK = "countries/Szekelyfold.txt"
LMT = "countries/Lamata.txt"
BJN = "countries/Bojano.txt"
GGN = "countries/Gargano.txt"
FGA = "countries/Foggia.txt"
LRN = "countries/Larino.txt"
CHT = "countries/Chieti.txt"
AVS = "countries/Aversa.txt"
CRK = "countries/Cork.txt"
DBL = "countries/Dublin.txt"
FAS = "countries/Fagaras.txt"
BAE = "countries/Barsei.txt"
LVI = "countries/Lovistea.txt"
BLH = "countries/Blahnita.txt"
COV = "countries/Craiova.txt"
BNZ = "countries/Burnaz.txt"
VSC = "countries/Vlasca.txt"
VLS = "countries/Vlasia.txt"
BZG = "countries/Baragan.txt"
VLH = "countries/Vlahia.txt"
ROI = "countries/Romani.txt"
IAS = "countries/Iasi.txt"
ONT = "countries/Onut.txt"
CDR = "countries/Codru.txt"
MSK	= "countries/Minsk.txt"
TUV	= "countries/Turov.txt"
PNK	= "countries/Pinsk.txt"
SKS	= "countries/Slutsk.txt"
VHN	= "countries/Volhynia.txt"
BTY = "countries/Berestye.txt"
LSK = "countries/Lutsk.txt"
DGO = "countries/Dorogobuzh.txt"
LAD = "countries/Ladik.txt"
TVS = "countries/Tavas.txt"
VNL = "countries/Veinala.txt"
KRN = "countries/Kran.txt"
LVC = "countries/Lovech.txt"
PPO = "countries/Philippopolis.txt"
SNI = "countries/Sasni.txt"
KLU = "countries/Kulmas.txt"
PLK = "countries/Poleksia.txt"
DNV = "countries/Dainava.txt"
NLS = "countries/Nalsia.txt"
DLT = "countries/Deltuva.txt"
UPY = "countries/Upyte.txt"
NRS = "countries/Neris.txt"
SUA = "countries/Siaulia.txt"
ZGR = "countries/Zagare.txt"
TVT = "countries/Tervete.txt"
DBE = "countries/Doube.txt"
PMR = "countries/Piemare.txt"
DUZ = "countries/Duvzare.txt"
PLS = "countries/Pilsotas.txt"
DZK = "countries/Dzukia.txt"
AUK = "countries/Aukstaitia.txt"
LUV = "countries/Lietuva.txt"
PJA = "countries/PallarsJussa.txt"
PSA = "countries/PallarsSobira.txt"
BEG = "countries/Berga.txt"
BRC = "countries/Barcelona.txt"
RIB = "countries/Ribagorza.txt"
LER = "countries/Lerida.txt"
CBR = "countries/Coimbra.txt"
PCA = "countries/Portucale.txt"
CTL = "countries/KingdomofToledo.txt"
CSE = "countries/KingdomofSevilla.txt"
CJA = "countries/KingdomofJaen.txt"
CCR = "countries/KingdomofCordoba.txt"
CGR = "countries/KingdomofGranada.txt"
CMU = "countries/KingdomofMurcia.txt"
AVL = "countries/KingdomofValencia.txt"
AGV = "countries/Algarve.txt"
MTL = "countries/Martulah.txt"
BJA = "countries/Baja.txt"
AGB = "countries/AlGharb.txt"
STN = "countries/Shantarin.txt"
MYU = "countries/Mayurqa.txt"
GDX = "countries/Guadix.txt"
JRC = "countries/Jerica.txt"
MLN = "countries/Molina.txt"
IFQ = "countries/Ifriqiya.txt"
SDZ = "countries/Malopolska.txt"
LPT = "countries/Lepanto.txt"
CTY = "countries/Calatayud.txt"
MNI = "countries/Mani.txt"
CBL = "countries/Crebilly.txt"
FCH = "countries/UiFiachrach.txt"
LGO = "countries/Loigis.txt"
UID = "countries/UiDiarmata.txt"
MGL = "countries/MaghLuirg.txt"
LRG = "countries/Luirg.txt"
FHM = "countries/FhearMai.txt"
LGB = "countries/LochGabhair.txt"
BEE = "countries/Brega.txt"
LCH = "countries/Luachra.txt"
CHB = "countries/Chairbre.txt"
UIL = "countries/UiLiathain.txt"
BNN = "countries/Boireann.txt"
UIB = "countries/UiBairrche.txt"
AIN = "countries/TirAinmhireach.txt"
TUC = "countries/TulachOg.txt"
TYH = "countries/TeallachEathach.txt"
LCN = "countries/Lecan.txt"
LZO = "countries/Latium.txt"
VNA = "countries/Porhoet.txt"
NNT = "countries/Naoned.txt"
KNV = "countries/Kernev.txt"
LNE = "countries/Leoniz.txt"
PNT = "countries/Pentevr.txt"
BZT = "countries/Bizerte.txt"