#Mod additions
AAL	= "countries/Aalen.txt" 
ABR = "countries/Albret.txt"
ACN = "countries/IarConnacht.txt"
ADR = "countries/Andorra.txt"
AGO = "countries/Angouleme.txt"
AHA	= "countries/Ahaus.txt"
AMB	= "countries/Oldambt.txt" 
AME	= "countries/Ameland.txt"
AML	= "countries/Amalfi.txt"
ANC	= "countries/Ancona.txt"
ANJ = "countries/AnjouState.txt"
AOS	= "countries/Aosta.txt"
APZ	= "countries/Appenzell.txt" 
AQT = "countries/Aquitaine.txt"
ARI = "countries/Arianiti.txt"
ATO	= "countries/Artois.txt"
ASC	= "countries/Ascoli.txt"
AST	= "countries/Asti.txt"
ATR = "countries/Asturias.txt"
AUN = "countries/Aunis.txt"
AZZ	= "countries/Arezzo.txt"
BAA	= "countries/Blamont.txt"
BAU	= "countries/BmAugsburg.txt" 
BBB	= "countries/Bamberg.txt"
BBR	= "countries/Biberach.txt" 
BBX	= "countries/BmBrandenburg.txt"
BCH	= "countries/Bruchhausen.txt" 
BDW	= "countries/Badenweiler.txt" 
BEA = "countries/Beaujeu.txt"
BEB = "countries/Bearn.txt"
BGA	= "countries/Breisgau.txt" 
BGO	= "countries/Bornego.txt" 
BGR = "countries/Bigorre.txt"
BGS	= "countries/BmRegensburg.txt"
BGU	= "countries/Belgium.txt"
BGX	= "countries/Burgau.txt" 
BHH	= "countries/Buchhorn.txt" 
BKX	= "countries/Blankenburg.txt" 
BKY = "countries/Biscay.txt"
BLG	= "countries/Bologna.txt"
BLL = "countries/Bouillon.txt"
BLO = "countries/Blois.txt"
BLR = "countries/Belarus.txt"
BMB	= "countries/BmBasel.txt" 
BME	= "countries/BMeissen.txt"
BMK	= "countries/BmKonstanz.txt" 
BML	= "countries/BmLubeck.txt" 
BMM	= "countries/BmMetz.txt"
BMS	= "countries/BmSpeyer.txt" 
BMT	= "countries/BmToul.txt" 
BMV	= "countries/BmVerdun.txt"
BNA = "countries/Branach.txt"
BNE	= "countries/Benevento.txt"
BNT	= "countries/Bentheim.txt" 
BPF	= "countries/Bopfingen.txt" 
BRD	= "countries/Breda.txt"
BRF = "countries/Breiene.txt" 
BRG	= "countries/Berg.txt" 
BRN	= "countries/Bern.txt" 
BRT = "countries/Berat.txt"
BRZ	= "countries/Brzeg.txt"
BSC	= "countries/Besancon.txt"
BSL	= "countries/Basel.txt" 
BTG	= "countries/Berchtesgaden.txt" 
BTH	= "countries/Barth.txt"
BUC	= "countries/Buchau.txt"
BWX	= "countries/BmSchwerin.txt" 
BXI	= "countries/Brixen.txt"
BYT	= "countries/Bytom.txt"
CAR	= "countries/Carrara.txt"
CBY = "countries/Clandeboye.txt"
CCL = "countries/CorcuLoigde.txt"
CCU = "countries/Clancullen.txt"
CES	= "countries/Cesena.txt"
CGO	= "countries/Correggio.txt"
CIE	= "countries/Cieszyn.txt"
CLB = "countries/Calenberg.txt"
CLI	= "countries/Cilli.txt"
CMB	= "countries/Cambrai.txt"
CMM	= "countries/Cammin.txt"
CMR	= "countries/Camerino.txt"
COS	= "countries/Cospaia.txt"
CPG	= "countries/Carpegna.txt"
CPU	= "countries/Capua.txt"
CRP	= "countries/Carpi.txt"
CRV	= "countries/Corvey.txt"
CTH	= "countries/Carinthia.txt" 
CVA	= "countries/Ceva.txt"
CYB	= "countries/CityBremen.txt"
DAW	= "countries/Donauworth.txt" 
DGL = "countries/Donegal.txt"
DHN	= "countries/Dohna.txt" 
DIE	= "countries/Worms.txt" 
DIX	= "countries/DixJuridictions.txt" 
DKG = "countries/Dukagjini.txt"
DKJ = "countries/DonjiKraji.txt"
DKL	= "countries/Dinkelsbuhl.txt"
DLM = "countries/Dalmatia.txt"
DMD	= "countries/Dortmund.txt"
DMH	= "countries/Delmenhorst.txt" 
DMR	= "countries/Dithmarschen.txt"
DNO = "countries/Dunois.txt"
DOL	= "countries/Dolceacqua.txt"
DPH	= "countries/Diepholz.txt" 
DRZ = "countries/Durazzo.txt"
DXS	= "countries/Disentis.txt" 
EAH	= "countries/AustriaHungary.txt"
EBE	= "countries/Eberstein.txt"
EBG	= "countries/Engelberg.txt"
EBX	= "countries/Erbach.txt" 
ECH	= "countries/Eichstatt.txt"
EGH	= "countries/Enghien.txt"
EIL = "countries/Eile.txt"
ELL	= "countries/Ellwangen.txt"
EUU = "countries/Eu.txt"
EVE	= "countries/Everstein.txt" 
EXS	= "countries/Esslingen.txt"  
FAE	= "countries/Faenza.txt"
FBA	= "countries/Forbach.txt"
FBG	= "countries/Friedberg.txt"
FBO	= "countries/Fribourg.txt" 
FCM = "countries/FrancheComte.txt"
FDX	= "countries/Fulda.txt" 
FGO	= "countries/Fivelgo.txt" 
FIN	= "countries/Finale.txt"
FIU	= "countries/Fiume.txt"
FKE = "countries/Francia.txt"
FKN	= "countries/Franconia.txt"
FKS	= "countries/Falkenstein.txt" 
FMA = "countries/Fermanagh.txt"
FMO	= "countries/Fermo.txt"
FNB	= "countries/Furstenberg.txt"  
FNN	= "countries/Finstingen.txt" 
FNO	= "countries/Fano.txt"
FRL	= "countries/Forli.txt"
FRZ	= "countries/Forez.txt"
FSD	= "countries/Fosdinovo.txt"
FSS	= "countries/Fossombrone.txt"
FWS = "countries/Fews.txt"
FXI	= "countries/Freising.txt"
FXK	= "countries/Fleckenstein.txt" 
GAE	= "countries/Gaeta.txt"
GBU = "countries/Grubenhagen.txt"
GCH	= "countries/Gleichen.txt" 
GDL = "countries/Gundelfingen.txt"
GEH	= "countries/Gelnhausen.txt"
GEV = "countries/Gevaudan.txt"
GGB = "countries/Gengenbach.txt"
GIE	= "countries/Giengen.txt"  
GLA	= "countries/Glarus.txt" 
GLG	= "countries/Glogow.txt"
GLN = "countries/Gailenga.txt"
GLY = "countries/Glynnes.txt"
GMU	= "countries/Gmund.txt" 
GNG	= "countries/Groningen.txt" 
GNF	= "countries/Genf.txt" 
GRX	= "countries/Grise.txt" 
GRZ	= "countries/Gorizia.txt"
GSL	= "countries/Goslar.txt"
GST	= "countries/Guastalla.txt"
GTT	= "countries/Gottingen.txt"    
GTZ = "countries/Gutenzell.txt"
GUI = "countries/Vermandois.txt"
HAA	= "countries/Haag.txt" 
HNU	= "countries/Hanau.txt"
HBD	= "countries/Halberstadt.txt"
HBG	= "countries/Hohenburg.txt" 
HBN	= "countries/Heilbronn.txt"
HDS	= "countries/Hildesheim.txt"
HEL	= "countries/Helfenstein.txt"   
HGA	= "countries/Hagenau.txt" 
HGF	= "countries/HagenauFree.txt"
HGO	= "countries/Hunsigo.txt"
HHB	= "countries/Hohenberg.txt"   
HHH	= "countries/Hachberg.txt" 
HHN	= "countries/Hohnstein.txt" 
HLL	= "countries/Hall.txt" 
HLM	= "countries/Hohenlimburg.txt"
HLX	= "countries/Harlingerland.txt" 
HMA = "countries/Himara.txt"
HMB = "countries/Homburg.txt"
HOO	= "countries/Hohenlohe.txt" 
HOR	= "countries/Hoorn.txt" 
HOY	= "countries/Hoya.txt"
HUM = "countries/Hum.txt"
HVB	= "countries/Havelberg.txt"
HWN	= "countries/Howen.txt"
HZS	= "countries/Sigmaringen.txt"
IAB = "countries/IarBriefne.txt"
ICN = "countries/IorConnacht.txt"
IMO	= "countries/Imola.txt"
ICA	= "countries/Incisa.txt"
ING	= "countries/Ingolstadt.txt" 
INH = "countries/InisEoghain.txt"
ISE	= "countries/Isenburg.txt"
ISN	= "countries/Isny.txt"
IVE = "countries/Iveagh.txt"
JCH	= "countries/Julich.txt" 
JWR	= "countries/Jawor.txt"
KUF	= "countries/Kaufbeuren.txt" 
KAY	= "countries/Kayserberg.txt"
KEE = "countries/Keenaght.txt"
KGG = "countries/Konigsegg.txt"
KGZ	= "countries/Hohengeroldseck.txt"  
KHR	= "countries/Chur.txt"
KIL	= "countries/Kiel.txt"
KLG = "countries/Klingenberg.txt"
KLK	= "countries/Lombardy.txt"
KLL	= "countries/Castell.txt" 
KMM = "countries/Comminges.txt"
KMR	= "countries/Colmar.txt"  
KNZ	= "countries/Konstanz.txt"
KOF	= "countries/CologneFree.txt"
KOG	= "countries/God.txt"
KPF	= "countries/KemptenFree.txt"  
KPT	= "countries/Kempten.txt"
KRJ = "countries/Krivaja.txt"
KRM	= "countries/Cornelimunster.txt" 
KRR	= "countries/Krain.txt" 
KRY = "countries/Kerry.txt"
KSI = "countries/Karesi.txt"
KST = "countries/Kastrioti.txt"
KXR	= "countries/Kirchberg.txt"  
KZB	= "countries/Katzenelnbogen.txt"
LBG	= "countries/Limburg.txt" 
LBO = "countries/Lesbos.txt"
LBV = "countries/LombardyVenetia.txt"
LCS = "countries/Lancaster.txt"
LDU = "countries/Northlindau.txt"
LGL	= "countries/Lengenerland.txt" 
LGV = "countries/Roussillon.txt"
LKK	= "countries/Leutkirch.txt"
LKR	= "countries/Lucerne.txt"
LMA = "countries/Lamarche.txt"
LMO = "countries/Limoges.txt"
LMP	= "countries/Limpurg.txt" 
LNN	= "countries/Legnica.txt"
LNU	= "countries/Lindau.txt" 
LOA	= "countries/Loano.txt" 
LOO = "countries/Loon.txt"
LPF	= "countries/Lupfen.txt" 
LPP	= "countries/Lippe.txt" 
LSH	= "countries/Landshut.txt" 
LSN = "countries/Lausanne.txt"
LST	= "countries/Lausitz.txt"
LSX	= "countries/Leichtenstein.txt"
LTB	= "countries/Lichtenberg.txt" 
LTH	= "countries/Lotharingia.txt"
LUZ	= "countries/Lutzelstein.txt"      
LWS	= "countries/Lowenstein.txt"
LXU	= "countries/Luxeuil.txt"  
LYO	= "countries/Lyon.txt"
MAF = "countries/Galloway.txt"
MBC	= "countries/Murbach.txt" 
MCE	= "countries/Macerata.txt"
MCO	= "countries/Monaco.txt"
MDS	= "countries/Manderscheid.txt"
MFO	= "countries/Montfort.txt" 
MFX	= "countries/Mansfeld.txt" 
MGF = "countries/Yugoslavia.txt"
MIN	= "countries/Minden.txt" 
MIR	= "countries/Mirandola.txt"
MIS	= "countries/Misox.txt"
MMB	= "countries/Merseburg.txt" 
MMU = "countries/Mumu.txt"
MNE = "countries/Maine.txt"
MNN = "countries/Mann.txt"
MOM	= "countries/Mompelgard.txt"
MRK	= "countries/Mark.txt" 
MRS	= "countries/Moers.txt"
MRV	= "countries/Moravia.txt" 
MII = "countries/Misia.txt"
MSS	= "countries/Masserano.txt"
MTZ	= "countries/Metz.txt" 
MUA	= "countries/MulhausenAlsace.txt"
MUF	= "countries/MunsterFree.txt"
MUL	= "countries/Munchen.txt" 
MUT	= "countries/MulhausenThuringia.txt"  
MXD = "countries/Macedonia.txt"
MXX	= "countries/Massa.txt" 
NCH	= "countries/Neuchatel.txt"  
NDD	= "countries/Nidda.txt"
NDW	= "countries/Nidwalden.txt" 
NEM = "countries/Nemours.txt"
NGC	= "countries/NorthGermanConfederation.txt" 
NGF	= "countries/Leuchtenberg.txt"
NIC	= "countries/Nice.txt"
NLA	= "countries/Novellara.txt"
NLI	= "countries/Noli.txt"
NLX	= "countries/Nellenburg.txt"  
NMR	= "countries/Namur.txt"
NMU	= "countries/Naumburg.txt" 
NMY	= "countries/Namyslow.txt"
NNG	= "countries/Leiningen.txt"
NNH	= "countries/Neuenahr.txt" 
NNN	= "countries/Henneburg.txt"
NOA	= "countries/Nordhausen.txt"
NOI	= "countries/Nordlingen.txt"
NRB = "countries/Narbonne.txt"
NRV	= "countries/NorthRavensberg.txt"
NUO	= "countries/Nurnberg.txt" 
NYS	= "countries/Nysa.txt"
OBR	= "countries/Obernai.txt"
OCH	= "countries/Ochsenhausen.txt"
OET	= "countries/Oettingen.txt"
OFF	= "countries/Offenburg.txt" 
OGO	= "countries/Ostergo.txt" 
OIE = "countries/Oriel.txt"
OLL	= "countries/Overledingerland.txt" 
OLS	= "countries/Olesnica.txt"
OMO = "countries/Ormond.txt"
ONB	= "countries/Osnabruck.txt"
ONE	= "countries/Oneglia.txt"
OPO	= "countries/Opole.txt"
ORA	= "countries/Orange.txt"
ORT = "countries/Ortenburg.txt"
OSS = "countries/Ossory.txt"
OSW	= "countries/Oswiecim.txt"
OTB	= "countries/Ottobeuren.txt"
OTT	= "countries/Ottieri.txt"
OXR	= "countries/Orlamunde.txt"
PAA	= "countries/Passau.txt" 
PDR	= "countries/Paderborn.txt" 
PET = "countries/Petershausen.txt"
PFE = "countries/Pfeddersheim.txt"
PFU	= "countries/Pfullendorf.txt"
PGD = "countries/Perigord.txt"
PNI = "countries/Petrispanili.txt"
POB	= "countries/Piombino.txt"
POJ	= "countries/Poljica.txt"
POU = "countries/Poitou.txt"
PPP	= "countries/Pappenheim.txt"
PRG	= "countries/Perugia.txt"
PRZ = "countries/Deols.txt"
PSO	= "countries/Pesaro.txt"
PTH	= "countries/Pruthenia.txt"
PTR	= "countries/Pietramala.txt"
PTT	= "countries/Puttlingen.txt"
PUM	= "countries/Prum.txt" 
PXU	= "countries/Padua.txt" 
PYR	= "countries/Pyrmont.txt"
QDL = "countries/Quedlinburg.txt"
RAP	= "countries/Rappolstein.txt" 
RCB	= "countries/Raciborz.txt"
RCH	= "countries/Rochefort.txt"
RDZ = "countries/Rodez.txt"
REU	= "countries/Reutlingen.txt"
RGB	= "countries/Regensburg.txt" 
RGO	= "countries/Reggio.txt"
RGS = "countries/Rigastadt.txt"
RMG	= "countries/Romagna.txt"
RMI	= "countries/Rimini.txt"
RNK	= "countries/Rieneck.txt" 
ROE	= "countries/Rothenburg.txt"  
ROL	= "countries/Rolo.txt"
ROT	= "countries/Rottenmunster.txt"
RPP	= "countries/Ruppin.txt" 
RSB	= "countries/Rendsburg.txt"     
RSH	= "countries/Rosheim.txt"
RTL = "countries/Rethel.txt"
RTZ	= "countries/Ratzeburg.txt" 
RVE	= "countries/Ravenna.txt"
RWI	= "countries/Rottweil.txt" 
RYL	= "countries/Ricklingen.txt"
RYS	= "countries/Rustringen.txt" 
SAU	= "countries/Straubing.txt" 
SAM	= "countries/Sambia.txt"
SBB	= "countries/Schonburg.txt"
SCH	= "countries/Schwyz.txt"
SCR = "countries/Scuria.txt"
SCW	= "countries/Scinawa.txt"
SDT	= "countries/Schlettstadt.txt"
SEG	= "countries/Schaumberg.txt"
SET	= "countries/Stettin.txt"
SNO	= "countries/SantaFiora.txt"
SFF = "countries/Schaffhausen.txt"
SGA	= "countries/Sundgau.txt" 
SGB	= "countries/Spiegelberg.txt" 
SGC	= "countries/SouthGermanConfederation.txt"
SGT = "countries/Stuttgart.txt"
SGX	= "countries/Stargard.txt" 
SHT	= "countries/Heideck.txt" 
SJU	= "countries/SaintJulius.txt"
SKR = "countries/Sancerre.txt"
SLM	= "countries/Salm.txt" 
SLS	= "countries/Solms.txt" 
SLV	= "countries/Slovenia.txt"
SLX	= "countries/Solothurn.txt" 
SMB	= "countries/Schaumburg.txt"
SME	= "countries/Salem.txt" 
SMG	= "countries/Senigallia.txt"
SMM	= "countries/StabloMalmedy.txt" 
SMX	= "countries/SanMarino.txt"
SMZ	= "countries/StMoritz.txt" 
SNC	= "countries/Swidnica.txt"
SOE	= "countries/Soest.txt"
SOU = "countries/Soule.txt"
SOV	= "countries/Sovana.txt"
SPH	= "countries/Sponheim.txt"
SPT	= "countries/Spoleto.txt"
SPY	= "countries/Speyer.txt" 
SRR	= "countries/Schussenried.txt"
SSF	= "countries/Strassburg.txt"  
SSS	= "countries/BmStrassburg.txt" 
STC = "countries/SetteComuni.txt"
STE	= "countries/Stein.txt"
STF	= "countries/Steinfurt.txt"
STP	= "countries/Stolp.txt"
STT	= "countries/Sitten.txt" 
STX	= "countries/StGallen.txt" 
SVA = "countries/Slavonia.txt"
SVG = "countries/Slesvig.txt"
SVO	= "countries/Savona.txt"
SVV	= "countries/SanSeverino.txt"
SWB	= "countries/SwissBaden.txt"
SWG	= "countries/SaxonWaldburg.txt"
SWW	= "countries/Schweinfurt.txt" 
SWX	= "countries/Schwerin.txt" 
SXM	= "countries/Simmern.txt" 
SXT	= "countries/Stolberg.txt"
SYN	= "countries/Sayn.txt"
SZO	= "countries/Saluzzo.txt"
SZZ	= "countries/Schwarzburg.txt" 
TAI = "countries/Touraine.txt"
TBE = "countries/Tethbae.txt"
TCK	= "countries/Tecklenburg.txt"
TCN = "countries/Tyrconnell.txt"
TFW	= "countries/Lebus.txt" 
TGG	= "countries/Toggenburg.txt" 
THG = "countries/Thengen.txt"
THO	= "countries/Thorn.txt" 
TKN = "countries/Ticino.txt"
ARP = "countries/Arpitania.txt"
TNN	= "countries/Tonna.txt"
TNR = "countries/Tonnerre.txt"
TOF	= "countries/BmWorms.txt" 
TOL	= "countries/Toul.txt" 
TOR	= "countries/Tournai.txt"
TOX	= "countries/Thurgau.txt" 
TRK	= "countries/Turckheim.txt"
TRN	= "countries/Trent.txt"
TRO	= "countries/Troppau.txt"
TRS	= "countries/Tresana.txt"
TSA = "countries/Thassos.txt"
TSL	= "countries/Terschelling.txt" 
TSS = "countries/Thessaloniki.txt"
TST	= "countries/Trieste.txt"
TUG	= "countries/Truhendingen.txt"
TXC	= "countries/Teck.txt" 
UIF = "countries/UiFailghe.txt"
UIS = "countries/Uisnech.txt"
ULL	= "countries/Uberlingen.txt" 
UMA = "countries/UiMaine.txt"
UML = "countries/Umaill.txt"
UNC	= "countries/Heinsberg.txt" 
UPA = "countries/UpperPalatinate.txt"
URC = "countries/Urach.txt"
URI	= "countries/Uri.txt"
USR = "countries/Usora.txt"
UUS	= "countries/Sausenburg.txt"  
VAL	= "countries/Valentinois.txt"
VDD	= "countries/Verdun.txt" 
VDM	= "countries/Vaudemont.txt" 
VDN = "countries/Vidin.txt"
VDX	= "countries/Vaud.txt" 
VEF = "countries/VerdenFree.txt"
VGT	= "countries/Vogtland.txt" 
VIA = "countries/Vianen.txt"
VIV	= "countries/Viviers.txt"
VLD	= "countries/Veldenz.txt"
VLL	= "countries/Valais.txt" 
VLW = "countries/Valois.txt"
VMG	= "countries/Ventimiglia.txt"
VND = "countries/Vendome.txt"
VNN	= "countries/Verona.txt"
VNO	= "countries/Vernio.txt"
VRT = "countries/Vertus.txt"
WAC	= "countries/WeissenburgAlsace.txt"  
WBV	= "countries/WeissenburgBavaria.txt" 
WDK	= "countries/Waldeck.txt" 
WDS	= "countries/Windsheim.txt" 
WDX	= "countries/Wied.txt"  
WEE	= "countries/Wertheim.txt"
WER = "countries/Werden.txt"
WFB	= "countries/Wolfenbuttel.txt" 
WGD	= "countries/Wernigerode.txt" 
WGO	= "countries/Westergo.txt" 
WGS	= "countries/Wolgast.txt"
WGT	= "countries/Weingarten.txt"
WHE	= "countries/Wildenberg.txt" 
WKR	= "countries/Walkenried.txt" 
WLL	= "countries/Weil.txt"  
WNG = "countries/Wangen.txt"
WPF	= "countries/Wimpfen.txt"
WRC	= "countries/Wroclaw.txt"
WRL = "countries/Werle.txt"
WRM	= "countries/Warmia.txt"
WSS	= "countries/Wiesensteig.txt" 
WST	= "countries/Westenberg.txt"
WTY = "countries/Waterford.txt"
WUZ	= "countries/Hersfeld.txt" 
WWS	= "countries/Swabia.txt"
WXF = "countries/Wexford.txt"
WXL	= "countries/Waldburg.txt"
WYR	= "countries/Wursten.txt" 
WZL	= "countries/Wetzlar.txt" 
YBR = "countries/Brega.txt"
YRK = "countries/York.txt"
YST	= "countries/Ostringen.txt" 
ZAG	= "countries/Zagan.txt"
ZBB	= "countries/ZweibruckenBitsch.txt" 
ZDR = "countries/Zadrima.txt"
ZEE	= "countries/Zeeland.txt"
ZEL = "countries/Zell.txt"
ZGN	= "countries/Ziegenhain.txt" 
ZIE	= "countries/Ziebice.txt"
ZLX	= "countries/Zollern.txt"
ZTP = "countries/Zutphen.txt" 
ZUG	= "countries/Zug.txt" 
ZUR	= "countries/Zurich.txt" 
ZWB	= "countries/Zweibrucken.txt" 
ZWF	= "countries/Zwiefalten.txt"